..E.....D..
.......B...
.M.........
...........
..........S
..A........
........C..