.....A.....
..B......C.
...........
S..........
.........M.
........D..
.....E.....